//格式为日文[Tab]中文[Tab]解释(可不写)，参考项目wiki
静真	静真	人名，男性，全名"支仓静真"（支倉 静真，はせくら しずま），半精灵(父亲精灵/母亲人类)，外表与人类无异，16岁/高一，本作主人公，内向、认真、不擅女色、有些迟钝、老好人，寄宿在巴家
支倉静真	支仓静真	人名全名，男性，即"静真"
支倉	支仓	人名姓氏，静真的姓氏
シズマ	静真	人名，男性，静真的称呼
静真さん	静真同学	人名，男性，静真的称呼
静真くん	静真君	人名，男性，静真的称呼
静真君	静真君	人名，男性，静真的称呼
支倉君	支仓君	人名，男性，静真的称呼
下僕	下仆	人名代称，男性，阿兹对静真的称呼

リン	凛	人名，女性，对凛的称呼
凛さん	凛小姐	人名，女性，对凛的称呼
凛	凛	人名，女性，全名"凛·里姆=威姆斯"（凛・リム＝ウェムス），精灵，20岁/大学生，胆小、冒失、男性恐怖症、努力家，巴家同居人，眼镜娘，教育实习生（未来想当老师）
凛・リム＝ウェムス	凛·里姆=威姆斯	人名全名，女性，即"凛"
ウェムス	威姆斯	人名姓氏，凛的姓氏
ウェムスさん	威姆斯小姐	人名，女性，对凛的称呼
凛ちゃん	小凛	人名，女性，对凛的称呼

クルル	库露露	人名，女性，全名"敷岛库露露"（敷島 クルル），狼人，14-15岁/高二，跳级生，外表看起来像兽耳萝莉，无口、天才、有些天然、好奇心旺盛，由里亚的养女，会使用魔法
クルルちゃん	小库露露	人名，女性，对库露露的称呼
敷島クルル	敷岛库露露	人名全名，女性，即"库露露"
敷島	敷岛	人名姓氏，库露露的姓氏
敷島さん	敷岛同学	人名，女性，对库露露的称呼

ティータ	蒂塔	人名，女性，全名"蒂塔·F·布兰特"（ティータ・Ｆ・ブラント），人类，富家千金，巴家邻居，16岁/高一，高傲、傲娇、认真、努力家、大小姐口调
ティータちゃん	小蒂塔	人名，女性，对蒂塔的称呼
ティータさん	蒂塔同学	人名，女性，对蒂塔的称呼
ティータ・Ｆ・ブラント	蒂塔·F·布兰特	人名全名，女性，即"蒂塔"
ブラント	布兰特	人名姓氏，蒂塔的姓氏
ブラントさん	布兰特同学	人名，女性，对蒂塔的称呼

マキナ	真纪奈	人名，女性，对真纪奈的称呼
マキちゃん	小真纪	人名，女性，对真纪奈的称呼
真紀奈ちゃん	小真纪奈	人名，女性，对真纪奈的称呼
真紀奈さん	真纪奈同学	人名，女性，对真纪奈的称呼
真紀奈	真纪奈	人名，女性，全名"巴真纪奈"（巴 真紀奈，ともえ まきな），人类，16岁/高一，双胞胎(真纪奈和有希奈)中的妹妹，由里亚的女儿，活泼、直率、运动系、粗心
巴真紀奈	巴真纪奈	人名全名，女性，即"真纪奈"

ユキナ	有希奈	人名，女性，对有希奈的称呼
ユキ	有希	人名，女性，对有希奈的称呼
有希奈ちゃん	小有希奈	人名，女性，对有希奈的称呼
有希奈さん	有希奈同学	人名，女性，对有希奈的称呼
有希奈	有希奈	人名，女性，全名"巴有希奈"（巴 有希奈，ともえ ゆきな），人类，16岁/高一，双胞胎(真纪奈和有希奈)中的姐姐，由里亚的女儿，温柔、成熟、偶尔腹黑，有时会捉弄人
巴有希奈	巴有希奈	人名全名，女性，即"有希奈"

ユリア	由里亚	人名，女性，对由里亚的称呼
ユリアさん	由里亚阿姨	人名，女性，对由里亚的称呼
由里亜さん	由里亚阿姨	人名，女性，对由里亚的称呼
由里亜	由里亚	人名，女性，全名"巴由里亚"（巴 由里亜，ともえ ゆりあ），人类，双胞胎(真纪奈和有希奈)的妈妈，寡妇，巴家当主，温柔、母性、有些天然、喜欢照顾人
巴由里亜	巴由里亚	人名全名，女性，即"由里亚"

巴	巴	人名姓氏，真纪奈、有希奈和由里亚的姓氏

アズ	阿兹	无性别(代词统一为"它")，外表为黑猫玩偶，全名为"阿兹拉尔"(アズラエル)，库鲁鲁的使魔，毒舌、聒噪、傲慢、喜剧担当
アズちゃん	小阿兹	无性别(代词统一为"它")，外表为黑猫玩偶，阿兹的称呼
アズ様	阿兹大人	无性别(代词统一为"它")，外表为黑猫玩偶，阿兹的称呼
アズラエル	阿兹拉尔	外表为黑猫玩偶，库鲁鲁的使魔，毒舌、聒噪、傲慢、喜剧担当

フジ	阿藤	人名，男性，藤吉郎的称呼
藤吉郎	藤吉郎	人名，男性，全名"东村山藤吉郎"（東村山 藤吉郎，ひがしむらやま とうきちろう），16岁/高一，巨汉(近2m)，留有浓密胡须、沉默寡言、声音小、成绩优秀、有希奈的旧识
東村山藤吉郎	东村山藤吉郎	人名全名，男性，即"藤吉郎"
東村山くん	东村山同学	人名，男性，藤吉郎的称呼
東村山	东村山	人名姓氏，藤吉郎的姓氏

マリー	玛丽	人名，女性，全名"玛丽·凯利"（マリー・ケリー），狼人，16岁/高一，带有野性气质、真纪奈的社团队友（索菲罗斯社）、同班同学
マリー・ケリー	玛丽·凯利	人名全名，女性，即"玛丽"
ケリー	凯利	人名姓氏，玛丽的姓氏
ケリーさん	凯利同学	人名，女性，玛丽的称呼

はるな	春奈	人名，女性，全名"馆川春奈"（舘川 はるな，たちかわ はるな），人类，17岁/高二，内向、畏缩、库露露的朋友、图书委员，眼镜娘
舘川はるな	馆川春奈	人名全名，女性，即"春奈"
舘川	馆川	人名姓氏，春奈的姓氏
舘川先輩	馆川前辈	人名，女性，对春奈的称呼
舘川さん	馆川同学	人名，女性，对春奈的称呼

フィル	菲尔	人名，男性，全名为"菲利普·宫川"（フィリップ・ミヤガワ），"菲尔"为昵称，精灵，16岁/高一，美型、轻浮、好女色、足球部社员、静真的损友、金发碧眼
フィルくん	菲尔同学	人名，男性，对菲尔的称呼
フィリップ・ミヤガワ	菲利普·宫川	人名全名，男性，即"菲尔"
ミヤガワ君	宫川君	人名，男性，对菲尔的称呼

ケン	健	人名，男性，全名"关屋健"（関屋 ケン），狼人，老师，1年A班班主任，怯懦、声音小，现代国语科目教师
関屋先生	关屋老师	人名，男性，健(ケン)的称呼

ラエル	拉埃尔	人名，男性，蒂塔的哥哥，虽是天才但已离家成为一名研究者
ラエルさん	拉埃尔先生	人名，男性，拉埃尔(蒂塔的哥哥)的称呼

カイト	海斗	人名，男性，全名"炭谷海斗"(炭谷 カイト)，人类，16岁/高一，曾向蒂塔表白被拒，将静真视为情敌
炭谷君	炭谷君	人名，男性，炭谷海斗的称呼

// 其他
将星学園	将星学园	地名/学校名，静真所就读的学校，名门学校，实行三科制（普通科、体育科、魔法科）
図書委員会	图书委员会	静真、库露露和春奈所属的委员会，女性成员比例较高
巴家	巴家	地名，双胞胎(真纪奈和有希奈)的家，静真所寄宿的地方

ヒューマン	人类	种族名，人类，无特定特征，平凡但人数最为众多的种族
ライカン	狼人	种族名，拥有兽耳与尾巴，肉体能力优越
エルファン	精灵	种族名，妖精系种族，拥有长耳，魔法天赋优越

制御リング	控制环	用于抑制魔法力量的装备，魔法科学生需佩戴
魔法士	魔法师	以魔法为职业者，或泛指所有拥有魔法能力的人

ソフィロス	索菲罗斯	一种使用魔法手杖的球类运动，是真纪奈擅长的专业运动，以女子运动而闻名
ソフィロス部	索菲罗斯部	社团名，针对"索菲罗斯"(一种使用魔法手杖的球类运动)的社团

アクアリウム	水族饲养	静真的爱好（饲养热带鱼）。真纪奈等人提议为他设置水族箱